#####################
#.........#.........#
#.###.###.#.###.###.#
#.###.###.#.###.###.#
#.###.###.#.###.###.#
#.........O.........#
#.###.#.#####.#.###.#
#.###.#.#####.#.###.#
#.....#...#...#.....#
#####################