#####################
 .........#......... 
#.###.###.#.###.###.#
#.###.###.#.###.###.#
#.###.###.#.###.###.#
#.........O.........#
#.###.#.#####.#.###.#
#.###.#.#####.#.###.#
 .....#.......#..... 
#####################