#####################
 .........#......... 
#.###.###.#.###.###.#
#.###.###.#.###.###.#
#.###.###.#.###.###.#
#.........O.........#
#.###.#.#####.#.###.#
#.###.#.#####.#.###.#
 .....#...N...#..... 
#####################