#####################
#.........#.........#
#.###.###.#.###.###.#
#.###.###.#.###.###.#
#.###.###.#.###.###.#
#.........O.........#
#.###.#.#####.#.###.#
#.###.#.#####.#.###.#
#..N..#.......#..N..#
#####################