#####################
 .........#......... 
#.###.###.#.###.###.#
#.###.###.#.###.###.#
#.###.###.#.###.###.#
#.........O.........#
#.###.#.#####.#.###.#
#.###.#.#####.#.###.#
 .....#...#...#..... 
#####.### # ###.#####
    #.#N     N#.#    
    #.# ## ## #.#    
#####.# #   # #.#####
     .  #  N#  .     
#####################